____________________________
____________________________
__###########C############__
__#______________________#__
__#__________________$___#__
__S______________________#__
__#______________________#__
__#__________^___________#__
__G______________________C__
__#______________________#__
__#___$__________________#__
__#______________________#__
__###########C############__
____________________________
____________________________
