____________________________
____________________________
__########################__
__#______________________#__
__#__________________$___#__
__#______________________#__
__#______________________#__
__#__________^___________#__
__#______________________#__
__#______________________#__
__#___$__________________#__
__#______________________#__
__########################__
____________________________
____________________________
