___________________________________________________________
___________________________________________________________
___________________________________________________________
___________________________________________________________
_____#################################################_____
_____#################################################_____
_____#################################################_____
_____#################################################_____
_____####_________________________________________####_____
_____####_________________________________________####_____
_____####_________________________________________####_____
_____####_________________________________________####_____
_____####_________________________________________####_____
_____####_________________________________________####_____
_____####_________________________________________####_____
_____####_________________________________________####_____
_____####_________________________________________####_____
_____####_________________________________________####_____
_____#################################################_____
_____#################################################_____
_____#################################################_____
_____#################################################_____
___________________________________________________________
___________________________________________________________
___________________________________________________________
___________________________________________________________
